,Positive,Negative,Game_id,Game_name,Total_rating,Review_score,Rating
0,265404,3235,620,Portal 2,268639,0.987957816996043,97.66327950098795
1,163645,2138,1145360,Hades,165783,0.9871036234113268,97.40304064206218
2,129738,1587,427520,Factorio,131325,0.9879154768703597,97.38689970264602
3,71294,805,1118200,People Playground,72099,0.9888347965991207,97.19778899824689
4,817296,17421,105600,Terraria,834717,0.9791294534554825,97.12246372784107
5,550890,11688,292030,The Witcher 3: Wild Hunt,562578,0.9792242142422918,97.03207086697228
6,397085,8153,413150,Stardew Valley,405238,0.9798809588439387,97.00398456039339
7,420108,8893,431960,Wallpaper Engine,429001,0.9792704445910383,96.96090138657316
8,94865,1545,400,Portal,96410,0.9839746914220516,96.86831577080031
9,115706,2023,294100,RimWorld,117729,0.9828164683298083,96.84518880769994
10,62367,894,546560,Half-Life: Alyx,63261,0.9858680703751126,96.8440761526173
11,470846,11539,227300,Euro Truck Simulator 2,482385,0.9760792727800408,96.681509259249
12,16028,113,1229490,ULTRAKILL,16141,0.9929991945976085,96.632294151061
13,98558,1989,1289310,Helltaker,100547,0.9802182064109322,96.52360554939098
14,170462,3867,250900,The Binding of Isaac: Rebirth,174329,0.9778178042666452,96.51863865130093
15,541591,14740,550,Left 4 Dead 2,556331,0.9735049817464783,96.46781129529003
16,98550,2113,646570,Slay the Spire,100663,0.97900916920815,96.40699247815657
17,131166,3054,48700,Mount & Blade: Warband,134220,0.9772463120250335,96.35968728635815
18,40067,708,460950,Katana ZERO,40775,0.9826364193746168,96.28780997141843
19,71202,1510,508440,Totally Accurate Battle Simulator,72712,0.9792331389591814,96.27493979022887
20,184152,4787,10,Counter-Strike,188939,0.9746637803735597,96.241608630504
21,75090,1718,433340,Slime Rancher,76808,0.9776325382772628,96.14726513190001
22,343180,10081,739630,Phasmophobia,353261,0.9714630259213443,96.13866573081592
23,134025,3644,960090,Bloons TD 6,137669,0.9735307149757753,96.00905877974296
24,128437,3483,220,Half-Life 2,131920,0.9735976349302607,95.9981888859834
25,50196,1143,1366540,Dyson Sphere Program,51339,0.9777362239233331,95.94888797285907
26,42301,947,504230,Celeste,43248,0.9781030336662967,95.88741689899081
27,179092,5421,367520,Hollow Knight,184513,0.970619956317441,95.83896437972737
28,96473,2698,883710,Resident Evil 2,99171,0.9727944661241693,95.79826127556366
29,732724,25874,4000,Garry's Mod,758598,0.9658923435073649,95.79814505809705
30,61377,1614,205100,Dishonored,62991,0.9743772919940944,95.73402172314752
31,65516,1766,219150,Hotline Miami,67282,0.9737522665794714,95.70718468354129
32,46285,1158,213670,South Park: The Stick of Truth,47443,0.9755917627468752,95.69895979105993
33,70033,2011,526870,Satisfactory,72044,0.9720865026927988,95.58034015993422
34,61250,1739,238460,BattleBlock Theater,62989,0.9723920049532458,95.54260688401322
35,15468,297,264200,One Finger Death Punch,15765,0.9811607992388202,95.49397451749914
36,163054,5498,698780,Doki Doki Literature Club!,168552,0.9673809862831648,95.48994920972541
37,26089,615,250320,The Wolf Among Us,26704,0.976969742360695,95.4790143685629
38,84711,2659,588650,Dead Cells,87370,0.9695662126588074,95.42836191717161
39,101369,3285,548430,Deep Rock Galactic,104654,0.9686108509947063,95.4165968440009
40,76097,2365,644560,Mirror,78462,0.969858020443017,95.40628001159736
41,49298,1412,1113000,Persona 4 Golden,50710,0.9721553934135279,95.40541642044526
42,16165,346,424280,Iron Snout,16511,0.9790442735146266,95.32993602141447
43,89286,2933,219740,Don't Starve,92219,0.9681952742927162,95.32030613489736
44,160244,5703,391540,Undertale,165947,0.9656336059103208,95.31403348856412
45,13631,279,519860,DUSK,13910,0.9799424874191229,95.2783470121378
46,162393,5926,632360,Risk of Rain 2,168319,0.9647930417837558,95.23754893094592
47,44444,1350,274190,Broforce,45794,0.9705201554788837,95.19193311812214
48,53786,1703,207610,The Walking Dead,55489,0.9693092324604876,95.17983448794492
49,63396,2094,3590,Plants vs. Zombies GOTY Edition,65490,0.9680256527714155,95.14124056614743
50,93509,3298,284160,BeamNG.drive,96807,0.9659322156455629,95.12289467996902
51,280365,11179,322330,Don't Starve Together,291544,0.9616558735559642,95.12019802573273
52,30097,861,252150,Grimm,30958,0.972188125847923,95.118647213422
53,138473,5155,22380,Fallout: New Vegas,143628,0.9641086696187373,95.11029285583147
54,24542,675,32470,STAR WARS Empire at War - Gold Pack,25217,0.9732323432604989,95.0843715071304
55,196660,7755,203160,Tomb Raider,204415,0.9620624709536971,95.04191619560697
56,26236,750,365670,Blender,26986,0.9722078114577929,95.03189730903243
57,45611,1477,239030,"Papers, Please",47088,0.9686331974176011,95.02617183131765
58,16617,418,1454400,Cookie Clicker,17035,0.9754622835339007,95.01490577948391
59,88927,3235,270880,American Truck Simulator,92162,0.9648987652177687,95.00093397544076
60,172018,6798,264710,Subnautica,178816,0.9619832677165354,94.9863518128313
61,31295,952,629520,Soundpad,32247,0.9704778739107514,94.98076762343513
62,9713,201,341800,Keep Talking and Nobody Explodes,9914,0.979725640508372,94.96656422116224
63,40773,1319,636480,Ravenfield,42092,0.9686638791219234,94.96602912694932
64,172857,6896,8930,Sid Meier's Civilization V,179753,0.9616362452921509,94.95446379704508
65,148499,5882,319630,Life is Strange - Episode 1,154381,0.961899456539341,94.92339016801243
66,64732,2337,70,Half-Life,67069,0.9651552878378983,94.87619206256652
67,45105,1558,683320,GRIS,46663,0.9666116623448985,94.82694393522051
68,74040,2779,1057090,Ori and the Will of the Wisps,76819,0.9638240539449876,94.81320301060202
69,72316,2718,457140,Oxygen Not Included,75034,0.9637764213556521,94.7974569046793
70,124225,5011,240,Counter-Strike: Source,129236,0.9612259741867591,94.78836038764987
71,78604,3000,268910,Cuphead,81604,0.9632370962207735,94.78474281516527
72,128551,5313,435150,Divinity: Original Sin 2 - Definitive Edition,133864,0.9603104643518795,94.71348677237678
73,55749,2070,206440,To the Moon,57819,0.9641986198308514,94.70915550926652
74,81766,3234,204360,Castle Crashers,85000,0.9619529411764706,94.67931492447097
75,16762,489,312990,The Expendabros,17251,0.9716538171700191,94.66384090604507
76,25956,852,420,Half-Life 2: Episode Two,26808,0.9682184422560429,94.64712486160117
77,74835,2959,238320,Outlast,77794,0.9619636475820758,94.6393790102266
78,22065,720,221640,Super Hexagon,22785,0.9684002633311389,94.55533084832847
79,11513,313,40970,Stronghold Crusader HD,11826,0.9735328936242178,94.53949257067019
80,59723,2396,311690,Enter the Gungeon,62119,0.9614288703939213,94.47871461279928
81,44228,1708,286160,Tabletop Simulator,45936,0.9628178335074887,94.45385449399264
82,15204,469,214560,Mark of the Ninja,15673,0.9700759267530147,94.44137766364578
83,266639,12642,892970,Valheim,279281,0.9547337627693971,94.43025473036936
84,30087,1100,312530,Duck Game,31187,0.9647288934491935,94.4104811330049
85,19066,640,41700,S.T.A.L.K.E.R.: Call of Pripyat,19706,0.9675225819547346,94.36997713949539
86,22270,777,942970,Unheard,23047,0.9662862845489651,94.3620582561147
87,60948,2552,55230,Saints Row: The Third,63500,0.9598110236220473,94.33370499936683
88,59220,2479,212680,FTL: Faster Than Light,61699,0.9598210667920064,94.32034269366665
89,54537,2260,620980,Beat Saber,56797,0.9602091659770763,94.31578301154356
90,35799,1390,35140,Batman: Arkham Asylum Game of the Year Edition,37189,0.9626233563688187,94.31521803649284
91,32723,1261,304430,INSIDE,33984,0.9628943032015066,94.28759453976396
92,59119,2535,223470,POSTAL 2,61654,0.9588834463295164,94.22960487565702
93,26390,1002,339800,HuniePop,27392,0.963419976635514,94.20348354324663
94,47142,1988,387290,Ori and the Blind Forest: Definitive Edition,49130,0.9595359250966823,94.1749825832031
95,23566,886,386940,Ultimate Chicken Horse,24452,0.9637657451333225,94.16205730196695
96,87559,4027,221380,Age of Empires II (2013),91586,0.9560303976590309,94.13974110549684
97,35548,1466,500,Left 4 Dead,37014,0.9603933646728265,94.09885133124537
98,27705,1101,418240,Shadow Tactics: Blades of the Shogun,28806,0.9617787960841492,94.07898170504481
99,9523,293,9420,Supreme Commander: Forged Alliance,9816,0.9701507742461287,94.06025220224717
100,47179,2059,331470,Everlasting Summer,49238,0.958182704415289,94.04606989604834
101,267955,13948,239140,Dying Light,281903,0.9505219880597227,94.02164175323252
102,149294,7470,379720,DOOM,156764,0.9523487535403536,94.00021477530217
103,68826,3210,362890,Black Mesa,72036,0.9554389471930701,93.97295246888456
104,298850,15969,242760,The Forest,314819,0.9492756155124056,93.93345903486772
105,90056,4385,1237970,Titanfall 2,94441,0.9535688948655775,93.91487603261763
106,45871,2064,1426210,It Takes Two,47935,0.9569416918744132,93.91244208384376
107,39781,1763,200260,Batman: Arkham City - Game of the Year Edition,41544,0.9575630656653187,93.8936264536069
108,24060,993,261030,The Walking Dead: Season Two,25053,0.9603640282600886,93.8541380874059
109,113264,5719,8870,BioShock Infinite,118983,0.9519343099434373,93.853134095735
110,14338,533,32440,LEGO Star Wars - The Complete Saga,14871,0.9641584291574204,93.84155032753712
111,28204,1204,282140,SOMA,29408,0.9590587595212187,93.83229169834145
112,288970,15749,72850,The Elder Scrolls V: Skyrim,304719,0.9483163176565951,93.82986674201787
113,49161,2282,113200,The Binding of Isaac,51443,0.9556402231596135,93.82474439986996
114,19922,801,247080,Crypt of the NecroDancer,20723,0.9613472952757806,93.81925528273976
115,40488,1848,346010,Besiege,42336,0.9563492063492064,93.78771274989258
116,54116,2608,1196590,Resident Evil Village,56724,0.9540229885057471,93.71943444580135
117,32740,1480,107100,Bastion,34220,0.9567504383401519,93.70388844304891
118,26476,1160,871720,Ultimate Custom Night,27636,0.9580257634968882,93.69458938292397
119,44766,2122,261570,Ori and the Blind Forest,46888,0.9547432178809077,93.68934013493022
120,23074,993,629730,Blade and Sorcery,24067,0.958740183653966,93.67300885524024
121,148734,7997,814380,Sekiro: Shadows Die Twice - GOTY Edition,156731,0.9489762714459807,93.67209390066094
122,31671,1445,900883,The Elder Scrolls IV: Oblivion Game of the Year Edition Deluxe,33116,0.9563655030800822,93.64751780934296
123,31671,1445,22330,The Elder Scrolls IV: Oblivion Game of the Year Edition,33116,0.9563655030800822,93.64751780934296
124,5013,142,511470,Glass Masquerade,5155,0.9724539282250243,93.64091858769227
125,35672,1666,881100,Noita,37338,0.9553805774278216,93.62372956953398
126,22144,966,4700,Total War: MEDIEVAL II – Definitive Edition,23110,0.9581999134573778,93.59455761066265
127,24351,1081,4500,S.T.A.L.K.E.R.: Shadow of Chernobyl,25432,0.9574944951242529,93.59056676891323
128,52853,2640,714010,Aim Lab,55493,0.9524264321626151,93.55458426953106
129,23501,1061,257510,The Talos Principle,24562,0.9568031919224819,93.50199388713179
130,34126,1657,239820,Game Dev Tycoon,35783,0.9536930944862085,93.43749582849881
131,10452,407,2280,Ultimate Doom,10859,0.9625195690210885,93.43211813123506
132,19158,869,35720,Trine 2: Complete Story,20027,0.9566085784191342,93.34547866310065
133,59496,3162,1250,Killing Floor,62658,0.9495355740687542,93.33648988204894
134,142157,8215,477160,Human: Fall Flat,150372,0.945368818663049,93.3059432792841
135,44249,2295,50130,Mafia II (Classic),46544,0.9506918184943279,93.29617719816079
136,16445,738,236090,Dust: An Elysian Tail,17183,0.957050573240994,93.27808502655937
137,6488,232,102600,Orcs Must Die!,6720,0.9654761904761905,93.26874252293501
138,91656,5199,220200,Kerbal Space Program,96855,0.9463218212792318,93.22394927096904
139,10490,436,6020,STAR WARS Jedi Knight - Jedi Academy,10926,0.9600951857953506,93.20964922123484
140,5763,204,4580,"Warhammer 40,000: Dawn of War - Dark Crusade",5967,0.9658119658119658,93.18046065923527
141,28312,1425,692850,Bloodstained: Ritual of the Night,29737,0.9520799004607056,93.17275683994362
142,69260,3872,282070,This War of Mine,73132,0.9470546409232621,93.17043512542448
143,25102,1250,1167630,Teardown,26352,0.952565270188221,93.14362786696464
144,274248,17074,374320,DARK SOULS III,291322,0.9413913127055286,93.13940048274922
145,12424,547,35700,Trine Enchanted Edition,12971,0.9578290031608974,93.13705262582815
146,46481,2514,233860,Kenshi,48995,0.9486886416981325,93.13079905484076
147,17869,859,380,Half-Life 2: Episode One,18728,0.9541328492097394,93.06350131834236
148,9922,430,12900,AudioSurf,10352,0.9584621329211747,93.01059280414987
149,771548,51676,440,Team Fortress 2,823224,0.9372272917213298,92.99836203509794
150,16848,820,204450,Call of Juarez: Gunslinger,17668,0.9535884084220059,92.97034908762384
151,17131,837,22320,The Elder Scrolls III: Morrowind Game of the Year Edition,17968,0.9534171861086376,92.96619876170787
152,25509,1336,434570,Blood and Bacon,26845,0.9502328180294282,92.93296772460067
153,65461,3850,601150,Devil May Cry 5,69311,0.9444532613870814,92.89437699796545
154,27680,1488,40800,Super Meat Boy,29168,0.9489851892484915,92.86542846190906
155,11128,516,9450,"Warhammer 40,000: Dawn of War - Soulstorm",11644,0.9556853315012024,92.84811856260495
156,50465,2924,418370,Resident Evil 7 Biohazard,53389,0.9452321639288992,92.84255860958346
157,35977,2014,225080,Brothers - A Tale of Two Sons,37991,0.946987444394725,92.82948055918733
158,63892,3808,424840,Little Nightmares,67700,0.9437518463810931,92.8156818482546
159,11376,535,6000,STAR WARS Republic Commando,11911,0.955083536227017,92.81000864735401
160,150024,9588,322170,Geometry Dash,159612,0.9399293286219081,92.79866072539366
161,41010,2349,638970,Yakuza 0,43359,0.9458243963191033,92.7907578973178
162,19880,1038,383980,Rivals of Aether,20918,0.9503776651687542,92.78371192215832
163,45330,2646,200510,XCOM: Enemy Unknown,47976,0.9448474237118559,92.75062012532308
164,12589,626,3830,Psychonauts,13215,0.95262958758986,92.66179187994781
165,14383,733,219890,Antichamber,15116,0.9515083355385022,92.65898721904937
166,83961,5284,813780,Age of Empires II: Definitive Edition,89245,0.9407922012437672,92.65374977187962
167,26739,1499,57300,Amnesia: The Dark Descent,28238,0.9469155039308733,92.64799567190828
168,8150,375,2310,QUAKE,8525,0.9560117302052786,92.61094872891708
169,237641,16171,49520,Borderlands 2,253812,0.9362874883772241,92.59871385644412
170,39033,2319,246620,Plague Inc: Evolved,41352,0.9439204875217644,92.58238411403781
171,12459,633,50,Half-Life: Opposing Force,13092,0.9516498625114573,92.56213350205851
172,9669,470,969990,SpongeBob SquarePants: Battle for Bikini Bottom - Rehydrated,10139,0.9536443436236315,92.5409985959767
173,100199,6542,391220,Rise of the Tomb Raider,106741,0.9387114604509982,92.52683670743932
174,37191,2230,621060,PC Building Simulator,39421,0.9434311661297278,92.50923613724345
175,18831,1039,630,Alien Swarm,19870,0.9477101157523905,92.49537008983346
176,26418,1530,237930,Transistor,27948,0.9452554744525548,92.4832469259926
177,41278,2543,632470,Disco Elysium - The Final Cut,43821,0.9419684626092513,92.42631866791547
178,14437,777,563560,Alien Swarm: Reactive Drop,15214,0.94892861837781,92.42006758445665
179,24933,1465,7670,BioShock,26398,0.9445033714675354,92.37616594263864
180,25254,1492,555160,Pavlov VR,26746,0.9442159575263591,92.35692142303178
181,42939,2717,6060,"Star Wars: Battlefront 2 (Classic, 2005)",45656,0.9404897494305239,92.30602737564848
182,49598,3205,1217060,Gunfire Reborn,52803,0.9393026911349734,92.26647535539273
183,10247,547,6910,Deus Ex: Game of the Year Edition,10794,0.9493236983509357,92.18802722320062
184,2716,101,1058020,"STAR WARS Battlefront (Classic, 2004)",2817,0.9641462548810792,92.16726493115722
185,98162,6841,594570,Total War: WARHAMMER II,105003,0.9348494804910336,92.1458715681299
186,13024,735,1049410,Superliminal,13759,0.9465804200886693,92.12261338684964
187,52119,3488,787860,Farming Simulator 19,55607,0.9372740841980326,92.09689234246066
188,36283,2350,752590,A Plague Tale: Innocence,38633,0.9391711749022856,92.08978167711021
189,15655,918,202170,Sleeping Dogs,16573,0.9446087008990527,92.07413748893836
190,78162,5451,674940,Stick Fight: The Game,83613,0.934806788418069,92.04670017691775
191,6538,329,4570,"Warhammer 40,000: Dawn of War - Game of the Year Edition",6867,0.9520897043832823,92.04506414544439
192,163758,11979,255710,Cities: Skylines,175737,0.9318356407586337,92.04474013004426
193,22141,1380,245170,Skullgirls 2nd Encore,23521,0.9413290251264828,92.0007531854822
194,6521,333,40950,Stronghold HD,6854,0.9514152319813248,91.98053480987622
195,14301,860,901242,Mass Effect 2 Digital Deluxe Edition,15161,0.9432755095310336,91.88332906483248
196,14301,860,24980,Mass Effect 2 (2010),15161,0.9432755095310336,91.88332906483248
197,13094,779,4760,Rome: Total War - Collection,13873,0.9438477618395444,91.87111304018366
198,65174,4625,219990,Grim Dawn,69799,0.9337383057063855,91.8634652620804
199,29357,1941,207140,SpeedRunners,31298,0.937983257716148,91.85668897425307
200,62207,4426,1190460,DEATH STRANDING,66633,0.9335764561103357,91.82659855023724
201,37917,2593,48000,LIMBO,40510,0.9359911133053567,91.81073065693252
202,142694,10788,211820,Starbound,153482,0.9297116274221081,91.7907948110516
203,58572,4210,1158310,Crusader Kings III,62782,0.9329425631550444,91.73780368335294
204,14099,874,249130,LEGO Marvel Super Heroes,14973,0.9416282642089093,91.71852403345058
205,543952,44120,945360,Among Us,588072,0.9249751731080548,91.71842001268449
206,26007,1743,248820,Risk of Rain,27750,0.9371891891891891,91.70932057009689
207,28729,1953,977950,A Dance of Fire and Ice,30682,0.9363470438693696,91.6887116869317
208,16308,1039,201790,Orcs Must Die! 2,17347,0.9401049172767626,91.68017480834514
209,1737,62,941460,Death Trash,1799,0.9655364091161757,91.67814289313213
210,13432,835,212480,Sonic & All-Stars Racing Transformed Collection,14267,0.9414733300623818,91.66810444587536
211,132597,10210,648800,Raft,142807,0.9285049052217328,91.64761506482087
212,160934,12586,976730,Halo: The Master Chief Collection,173520,0.9274665744582757,91.61503894660711
213,34498,2420,516750,My Summer Car,36918,0.9344493201148492,91.6123648686839
214,15806,1022,47780,Dead Space 2,16828,0.9392678868552413,91.57953980824122
215,10421,637,228200,Company of Heroes,11058,0.942394646409839,91.55702415326577
216,6844,389,410320,EARTH DEFENSE FORCE 4.1 The Shadow of New Despair,7233,0.9462187197566708,91.54748103734059
217,20578,1397,220440,DmC: Devil May Cry,21975,0.9364277588168373,91.4907098941112
218,14391,935,738060,Freddy Fazbear's Pizzeria Simulator,15326,0.9389925616599243,91.48652456966066
219,34066,2439,1080110,F1 2020,36505,0.9331872346253938,91.48528152976988
220,14647,956,17460,Mass Effect (2007),15603,0.9387297314618983,91.4746523739043
221,37146,2687,200710,Torchlight II,39833,0.9325433685637536,91.47107450469652
222,35170,2541,24240,PAYDAY The Heist,37711,0.9326191296969054,91.44870301110369
223,52461,3941,774171,Muse Dash,56402,0.9301265912556292,91.41563377360072
224,22203,1544,235460,METAL GEAR RISING: REVENGEANCE,23747,0.9349812607908368,91.40268449241063
225,9009,556,38410,Fallout 2: A Post Nuclear Role Playing Game,9565,0.941871406168322,91.3883097752076
226,6596,385,217200,Worms Armageddon,6981,0.9448503079787997,91.38717883941952
227,25945,1843,326460,ShellShock Live,27788,0.9336764070821938,91.37501031254584
228,9007,561,6860,Hitman: Blood Money,9568,0.9413670568561873,91.34133328399426
229,25795,1846,1840,Source Filmmaker,27641,0.9332151514055208,91.3278234384923
230,3648,189,1536610,OpenTTD,3837,0.9507427677873339,91.31585372413878
231,9883,628,21090,F.E.A.R.,10511,0.9402530682142517,91.31477526856422
232,35238,2604,274170,Hotline Miami 2: Wrong Number,37842,0.9311875693673696,91.31343250502893
233,9772,627,287450,Rise of Nations: Extended Edition,10399,0.9397057409366285,91.25466888978907
234,32283,2395,554620,Life is Strange: Before the Storm,34678,0.9309360401407232,91.24128153141132
235,42411,3229,50300,Spec Ops: The Line,45640,0.9292506573181419,91.22641023868596
236,20413,1450,1263850,Football Manager 2021,21863,0.933677903306957,91.22599234243756
237,18628,1312,365450,Hacknet,19940,0.9342026078234704,91.21561091405157
238,42836,3295,214490,Alien: Isolation,46131,0.928572976956927,91.16677814918248
239,7813,492,26800,Braid,8305,0.9407585791691752,91.16281931504987
240,18574,1326,447020,Farming Simulator 17,19900,0.9333668341708543,91.13494673012333
241,16020,1127,241600,Rogue Legacy,17147,0.9342742170642094,91.11993726176368
242,19057,1370,1282730,Loop Hero,20427,0.9329319038527439,91.11090108883845
243,41147,3202,10180,Call of Duty: Modern Warfare 2,44349,0.92779995039347,91.07239418923275
244,45729,3608,613100,House Flipper,49337,0.926870300180392,91.03694044242239
245,17123,1232,208580,STAR WARS Knights of the Old Republic II - The Sith Lords,18355,0.932879324434759,91.03451446183887
246,31935,2450,666140,My Time At Portia,34385,0.928748000581649,91.02716941405184
247,73008,5985,387990,Scrap Mechanic,78993,0.9242337928677224,91.00012491192054
248,21211,1573,438040,Shakes and Fidget,22784,0.9309603230337079,90.9939282066976
249,20998,1562,225840,Sven Co-op,22560,0.9307624113475177,90.96884414413834
250,35670,2823,10090,Call of Duty: World at War,38493,0.9266619904917778,90.88897120997244
251,6308,404,382490,Relic Hunters Zero: Remix,6712,0.9398092967818832,90.88174323512351
252,12463,889,38400,Fallout: A Post Nuclear Role Playing Game,13352,0.9334182144997004,90.85877882063917
253,19839,1494,282800,100% Orange Juice,21333,0.929967655744621,90.85754693441135
254,21174,1608,1259420,Days Gone,22782,0.929417961548591,90.84715991738928
255,4525,275,22000,World of Goo,4800,0.9427083333333334,90.81998057181339
256,18832,1424,39140,FINAL FANTASY VII,20256,0.9296998420221169,90.7984988614429
257,66153,5580,241930,Middle-earth: Shadow of Mordor,71733,0.9222115344402158,90.7629732220398
258,14942,1108,71340,Sonic Generations Collection,16050,0.9309657320872274,90.7606397808456
259,15164,1129,225260,Brutal Legend,16293,0.9307064383477567,90.7466515608173
260,140062,12418,394360,Hearts of Iron IV,152480,0.9185598111227702,90.70397676716783
261,13198,979,246900,Viscera Cleanup Detail,14177,0.9309444875502575,90.66973379068331
262,14792,1120,7940,Call of Duty 4: Modern Warfare,15912,0.9296128707893414,90.62662580952592
263,12680,943,204880,Sins of a Solar Empire: Rebellion,13623,0.9307788299199883,90.62484290182321
264,32422,2658,35450,Red Orchestra 2: Heroes of Stalingrad with Rising Storm,35080,0.924230330672748,90.60584983118
265,416465,39098,304930,Unturned,455563,0.9141765244324056,90.59769298694971
266,21470,1700,233130,Shadow Warrior,23170,0.926629261976694,90.59244480198512
267,2902,167,7760,X-COM: UFO Defense,3069,0.945584881068752,90.58476870766349
268,9377,675,395170,DISTRAINT: Deluxe Edition,10052,0.9328491842419419,90.58391240877792
269,5721,383,41000,Serious Sam HD: The First Encounter,6104,0.937254259501966,90.55491608734143
270,9059,654,218680,Scribblenauts Unlimited,9713,0.9326675589416247,90.53885931695524
271,37461,3143,221910,The Stanley Parable,40604,0.9225938331198896,90.52716556487421
272,13877,1065,65800,Dungeon Defenders,14942,0.9287244010172667,90.49807658505947
273,5638,384,4560,Company of Heroes - Legacy Edition,6022,0.9362338093656593,90.4473679336899
274,112361,10251,222880,Insurgency,122612,0.9163948063811046,90.41570112685883
275,22660,1859,12110,Grand Theft Auto: Vice City,24519,0.924181247196052,90.39429421367532
276,112710,10325,700330,SCP: Secret Laboratory,123035,0.9160807900191003,90.38648949601371
277,11620,893,356670,Spooky's Jump Scare Mansion,12513,0.9286342204107728,90.3593449505739
278,39412,3420,307690,Sleeping Dogs: Definitive Edition,42832,0.9201531565184908,90.32057451653311
279,18026,1468,601430,The Evil Within 2,19494,0.9246947778803735,90.29837019269767
280,19606,1627,33930,Arma 2: Operation Arrowhead,21233,0.9233739933122969,90.22800483227728
281,11205,878,845070,The Awesome Adventures of Captain Spirit,12083,0.9273359265083174,90.21068396727298
282,80422,7459,677620,Splitgate: Arena Warfare,87881,0.9151238606752313,90.16368555794728
283,10199,798,317360,Double Action: Boogaloo,10997,0.9274347549331636,90.14742472205948
284,27962,2423,955050,Bright Memory,30385,0.9202567056113213,90.14594062732557
285,69141,6405,211420,DARK SOULS: Prepare To Die Edition,75546,0.9152172186482408,90.10988133364314
286,44449,4012,201270,Total War: SHOGUN 2,48461,0.9172117785435712,90.09970300137076
287,21119,1800,238010,Deus Ex: Human Revolution - Director's Cut,22919,0.9214625419957241,90.09413021601675
288,17726,1494,1328670,Mass Effect Legendary Edition,19220,0.9222684703433923,90.05892534317097
289,13717,1127,304240,Resident Evil,14844,0.9240770681756939,90.0544245698413
290,4845,346,11450,Overlord,5191,0.9333461760739742,90.0354241309177
291,51311,4752,489520,Minion Masters,56063,0.9152382141519362,89.97927499044489
292,13323,1105,239350,Spelunky,14428,0.9234128084280565,89.97149486074495
293,12186,1002,224760,FEZ,13188,0.9240218380345769,89.9639190348154
294,64924,6136,12120,Grand Theft Auto: San Andreas,71060,0.9136504362510555,89.93237109770436
295,55063,5155,234140,Mad Max,60218,0.914394367132751,89.93084861609954
296,76663,7318,305620,The Long Dark,83981,0.9128612424238816,89.92632009694924
297,25192,2237,278360,A Story About My Uncle,27429,0.9184439826461045,89.91421639767613
298,65964,6291,323190,Frostpunk,72255,0.9129333610130786,89.87030898030206
299,43601,4057,414340,Hellblade: Senua's Sacrifice,47658,0.9148726341852365,89.86674921389333
300,17540,1523,569480,Kingdoms and Castles,19063,0.9201070135865289,89.8485448798913
301,35922,3314,17390,SPORE,39236,0.9155367519624834,89.83272137998605
302,17278,1505,460790,Bayonetta,18783,0.9198743544694671,89.8168297321629
303,16178,1406,55150,"Warhammer 40,000: Space Marine - Anniversary Edition",17584,0.9200409463148317,89.7890808218451
304,20274,1804,736190,Chinese Parents,22078,0.9182897001539995,89.76924581840385
305,12362,1049,42960,Victoria II,13411,0.9217806278428156,89.76489641022363
306,31781,2938,1139900,Ghostrunner,34719,0.9153777470549267,89.75296247180081
307,5411,414,2630,Call of Duty 2,5825,0.9289270386266094,89.73846945617794
308,157473,15992,238960,Path of Exile,173465,0.9078084916265529,89.70116784307451
309,50863,4885,244210,Assetto Corsa,55748,0.9123735380641458,89.70085912667727
310,50406,4845,848450,Subnautica: Below Zero,55251,0.9123092794700548,89.69052581741066
311,15804,1390,582500,We Were Here,17194,0.9191578457601489,89.69045418160462
312,18774,1679,394510,HELLDIVERS Dive Harder Edition,20453,0.917909353151127,89.6851769590891
313,414195,43726,230410,Warframe,457921,0.904511913627023,89.65160887532832
314,94362,9446,262060,Darkest Dungeon,103808,0.9090050863131935,89.63667034880542
315,20956,1911,471710,Rec Room,22867,0.9164297896532121,89.61397288549816
316,29918,2811,265630,Fistful of Frags,32729,0.9141128662653916,89.60001098106228
317,15770,1406,34030,Total War: NAPOLEON – Definitive Edition,17176,0.918141592920354,89.59352420647163
318,74502,7446,361420,ASTRONEER,81948,0.9091375018304291,89.55623322686395
319,55450,5462,863550,HITMAN 2,60912,0.9103296558970317,89.54431875373702
320,34802,3344,1222140,Detroit: Become Human,38146,0.9123368111990773,89.51143542884125
321,13709,1227,259080,Just Cause 2: Multiplayer Mod,14936,0.9178494911622924,89.47053329130453
322,21913,2050,266840,Age of Mythology: Extended Edition,23963,0.914451445979218,89.45403604084736
323,123057,12757,782330,DOOM Eternal,135814,0.9060700664143608,89.44974984184272
324,101510,10446,438100,VRChat,111956,0.9066954875129515,89.44111008720877
325,5236,420,275390,Guacamelee! Super Turbo Championship Edition,5656,0.9257425742574258,89.41557415199533
326,32625,3162,203140,Hitman: Absolution,35787,0.9116438930337832,89.41167908596076
327,187202,19879,107410,Arma 3,207081,0.9040037473259256,89.38630671784718
328,4838,386,22100,Mount & Blade,5224,0.9261102603369066,89.37310322894282
329,8953,780,17450,Dragon Age: Origins,9733,0.9198602691873009,89.34051663231584
330,45588,4559,493340,Planet Coaster,50147,0.9090872833868426,89.3351127342715
331,165980,17700,489830,The Elder Scrolls V: Skyrim Special Edition,183680,0.9036367595818815,89.31328862203519
332,7073,602,2100,Dark Messiah of Might & Magic,7675,0.9215635179153094,89.30322640519756
333,42577,4276,8190,Just Cause 2,46853,0.9087358333511194,89.26883156781291
334,64836,6670,206420,Saints Row IV,71506,0.9067211143120857,89.2660891812342
335,53668,5468,233450,Prison Architect,59136,0.9075351731601732,89.26178012897378
336,12212,1114,367450,Poly Bridge,13326,0.9164040222122167,89.25343343392869
337,23693,2299,535930,Two Point Hospital,25992,0.9115497076023392,89.22558933786041
338,10629,961,230230,Divinity: Original Sin (Classic),11590,0.917083692838654,89.2149178627986
339,10428,944,57690,Tropico 4,11372,0.9169890960253254,89.191734576288
340,32333,3229,108710,Alan Wake,35562,0.9092008323491367,89.17446414410426
341,22749,2220,475150,Titan Quest Anniversary Edition,24969,0.9110897512916016,89.1583142915217
342,63330,6603,287700,METAL GEAR SOLID V: THE PHANTOM PAIN,69933,0.9055810561537472,89.14660476855408
343,13292,1243,445980,Wizard of Legend,14535,0.9144822841417268,89.13357911881651
344,30388,3047,1286830,STAR WARS: The Old Republic,33435,0.9088679527441303,89.10991217930938
345,156192,17052,1172620,Sea of Thieves,173244,0.9015723488259334,89.09365579329138
346,20340,1986,668630,Tricolour Lovestory,22326,0.9110454178984144,89.08728389806492
347,39579,4049,201810,Wolfenstein: The New Order,43628,0.9071926285871459,89.08587854196405
348,21109,2068,1213210,Command & Conquer Remastered Collection,23177,0.9107736117702895,89.08401035426824
349,15422,1473,67370,The Darkness II,16895,0.9128144421426457,89.07818744481068
350,17316,1671,475550,Beholder,18987,0.9119924158634856,89.07629709182369
351,22187,2192,32370,STAR WARS - Knights of the Old Republic,24379,0.9100865498995037,89.04869687973108
352,19602,1922,553640,ICEY,21524,0.9107043300501766,89.03253041655773
353,18059,1766,80,Counter-Strike: Condition Zero,19825,0.9109205548549811,89.00198370403871
354,54210,5709,349040,NARUTO SHIPPUDEN: Ultimate Ninja STORM 4,59919,0.9047213738547039,88.9965541209229
355,23941,2403,10500,Total War: EMPIRE – Definitive Edition,26344,0.9087837837837838,88.96970815433488
356,62704,6726,20920,The Witcher 2: Assassins of Kings Enhanced Edition,69430,0.9031254500936194,88.90653823969456
357,18047,1788,17470,Dead Space,19835,0.9098563145954122,88.90128916267676
358,23434,2372,319510,Five Nights at Freddy's,25806,0.9080833914593506,88.89106775107753
359,26973,2771,105450,Age of Empires III (2007),29744,0.9068383539537386,88.85240634164877
360,1806,130,20540,Company of Heroes: Tales of Valor,1936,0.9328512396694215,88.85093649921015
361,12014,1157,491950,Orwell: Keeping an Eye On You,13171,0.9121554931288437,88.84459954777996
362,70422,7662,220240,Far Cry 3,78084,0.9018749039495928,88.83454185395433
363,73275,7990,1172380,STAR WARS Jedi: Fallen Order,81265,0.9016796899034024,88.83183496681204
364,3136,255,370910,Kathy Rain,3391,0.9248009436744323,88.80378233597702
365,15497,1536,237110,Mortal Kombat Komplete Edition,17033,0.9098221100217225,88.80027426604039
366,30273,3176,728880,Overcooked! 2,33449,0.9050494783102634,88.74488110729014
367,15270,1528,300,Day of Defeat: Source,16798,0.9090367900940588,88.71679716544485
368,4195,363,92800,SpaceChem,4558,0.9203598069328653,88.70791656249803
369,2288,178,3900,Sid Meier's Civilization IV,2466,0.9278183292781833,88.7069538739391
370,14453,1446,47810,Dragon Age: Origins - Ultimate Edition,15899,0.9090508837033776,88.68162091493727
371,5128,460,41500,Torchlight,5588,0.917680744452398,88.65790189899006
372,36841,3962,645630,Car Mechanic Simulator 2018,40803,0.9028992966203465,88.64086880296998
373,33630,3602,480490,Prey,37232,0.9032552642887839,88.62887119784966
374,27630,2928,414700,Outlast 2,30558,0.9041822108776753,88.61347636840281
375,27854,2955,244450,Men of War: Assault Squad 2,30809,0.9040864682398001,88.60876718169159
376,26904,2860,8980,Borderlands Game of the Year,29764,0.9039107646821664,88.57319415597495
377,9028,880,56437,"Warhammer 40,000: Dawn of War II: Retribution",9908,0.9111828825191765,88.54131337368283
378,8897,867,130,Half-Life: Blue Shift,9764,0.9112044244162228,88.53195084466257
379,58924,6584,203770,Crusader Kings II,65508,0.8994931916712463,88.53137763886735
380,9680,953,228280,Baldur's Gate: Enhanced Edition,10633,0.9103733659362363,88.51952812743407
381,10987,1096,448510,Overcooked,12083,0.9092940494910204,88.51301201900816
382,50492,5611,363970,Clicker Heroes,56103,0.8999875229488619,88.51125270893294
383,38720,4252,431240,Golf With Your Friends,42972,0.9010518477147911,88.48907949549721
384,24453,2614,42700,Call of Duty: Black Ops,27067,0.9034248346695237,88.47412429348213
385,33203,3632,242920,Banished,36835,0.9013981267815936,88.44551248133872
386,17121,1797,459820,Crush Crush,18918,0.905011100539169,88.41185102937303
387,44941,5029,108600,Project Zomboid,49970,0.8993596157694617,88.39812893675806
388,34551,3813,254700,Resident Evil 4,38364,0.9006099468251486,88.39059755637955
389,3016,261,107310,Cthulhu Saves the World,3277,0.9203539823008849,88.35994061067049
390,30847,3395,312660,Sniper Elite 4,34242,0.9008527539279247,88.35568708567229
391,52053,5907,265930,Goat Simulator,57960,0.8980848861283643,88.34250566366401
392,18678,1991,373420,Divinity: Original Sin - Enhanced Edition,20669,0.903672166045769,88.33961848372176
393,43507,4910,703080,Planet Zoo,48417,0.8985893384555012,88.30941063010229
394,31002,3437,1222670,The Sims 4,34439,0.9002003542495427,88.29624140193809
395,56760,6533,224260,No More Room in Hell,63293,0.8967816346199422,88.25518798122475
396,16402,1753,368230,Kingdom: Classic,18155,0.9034425778022583,88.2371395449585
397,4666,439,931690,Himno,5105,0.9140058765915768,88.23274972235401
398,41090,4666,678950,DRAGON BALL FighterZ,45756,0.8980243028236734,88.22854861607641
399,479940,59792,252950,Rocket League,539732,0.8892190939206865,88.1896982619922
400,13512,1438,10680,Aliens vs. Predator,14950,0.9038127090301004,88.14523373363156
401,7598,768,113020,Monaco: What's Yours Is Mine,8366,0.9081998565622759,88.12806851932571
402,9690,1006,437920,Tricky Towers,10696,0.905946148092745,88.10839396205185
403,9293,961,329050,Devil May Cry 4 Special Edition,10254,0.9062804759118392,88.10796945347951
404,13221,1411,209080,Guns of Icarus Online,14632,0.9035675232367414,88.10756347112009
405,43460,5051,242050,Assassin’s Creed IV Black Flag,48511,0.8958792851105934,88.04983896955966
406,17478,1922,323850,Move or Die,19400,0.9009278350515464,88.04019196818861
407,484596,61406,218620,PAYDAY 2,546002,0.8875352104937344,88.0270080777404
408,20500,2285,250820,SteamVR,22785,0.8997147245995172,88.02180142432901
409,28913,3322,880940,Pummel Party,32235,0.8969443151853576,87.95028216777605
410,22931,2605,367500,Dragon's Dogma: Dark Arisen,25536,0.8979871553884712,87.92294924732637
411,20808,2350,444640,Bloons TD Battles,23158,0.8985231885309612,87.91793787394494
412,5904,597,257350,Baldur's Gate II: Enhanced Edition,6501,0.9081679741578219,87.91279204963351
413,18627,2091,641990,The Escapists 2,20718,0.8990732696206197,87.90425680343662
414,25243,2897,322500,SUPERHOT,28140,0.8970504619758352,87.88760215842045
415,12348,1361,210770,Sanctum 2,13709,0.9007221533299292,87.79464925747111
416,5299712,713612,730,Counter-Strike: Global Offensive,6013324,0.8813281971834546,87.78561784601054
417,98591,12248,812140,Assassin's Creed Odyssey,110839,0.8894973790813703,87.76969019119363
418,4324,433,2700,RollerCoaster Tycoon 3: Platinum,4757,0.9089762455328989,87.7010633715636
419,55624,6807,20900,The Witcher: Enhanced Edition Director's Cut,62431,0.8909676282616008,87.68883829255994
420,25009,2938,1237950,STAR WARS Battlefront II,27947,0.8948724371131069,87.67602090589715
421,19933,2310,1274570,DEVOUR,22243,0.8961471024592006,87.66838683107592
422,21040,2451,391720,Layers of Fear,23491,0.89566216849006,87.65395878687548
423,6647,704,20500,Red Faction Guerrilla Steam Edition,7351,0.904230716909264,87.65150533088585
424,10984,1220,39000,Moonbase Alpha,12204,0.9000327761389708,87.64863432092342
425,4407,446,265210,Viscera Cleanup Detail: Santa's Rampage,4853,0.908098083659592,87.6392339050513
426,2391,223,20570,"Warhammer 40,000: Dawn of War II Chaos Rising",2614,0.91469013006886,87.58784708038418
427,23891,2849,1222700,A Way Out,26740,0.893455497382199,87.51668178185037
428,34253,4174,236430,DARK SOULS II,38427,0.8913784578551539,87.50674643151712
429,9021,1005,320,Half-Life 2: Deathmatch,10026,0.8997606223818073,87.47958552535918
430,41515,5126,39210,FINAL FANTASY XIV Online,46641,0.8900966960399649,87.47600532502953
431,3056,304,418070,Turbo Pug,3360,0.9095238095238095,87.39847152477456
432,29044,3565,334230,Town of Salem,32609,0.8906743537060321,87.3567862794964
433,10849,1246,8850,BioShock 2,12095,0.8969822240595288,87.35521628197436
434,19460,2345,675010,MudRunner,21805,0.8924558587479936,87.30582006595314
435,24415,2990,42910,Magicka,27405,0.8908958219303047,87.2859982063283
436,8671,985,332950,Dark Deception,9656,0.8979908864954432,87.28537335414713
437,27803,3434,1100600,Football Manager 2020,31237,0.890066267567308,87.2763964123529
438,12343,1452,48190,Assassin’s Creed Brotherhood,13795,0.8947444726350127,87.23507562279285
439,2210,215,252130,Divide By Sheep,2425,0.911340206185567,87.19627642648811
440,93815,12365,244850,Space Engineers,106180,0.8835468073083443,87.17754234454452
441,9055,1048,1173690,Resident Evil 3: Raccoon City Demo,10103,0.8962684351182817,87.15786751479119
442,6913,786,666220,CS2D,7699,0.8979088193271854,87.10038018254038
443,8106,936,214510,LEGO The Lord of the Rings,9042,0.8964830789648308,87.09410194028433
444,10157,1196,50620,Darksiders,11353,0.8946533955782613,87.09126479658117
445,13191,1591,251060,Wargame: Red Dragon,14782,0.8923690975510756,87.0568360075293
446,21365,2666,527230,For The King,24031,0.8890599642128917,87.03846734047424
447,4871,544,30,Day of Defeat,5415,0.8995383194829178,86.95045966157348
448,57339,7589,412020,Metro Exodus,64928,0.8831166830951207,86.94820750174024
449,6843,792,368370,Her Story,7635,0.8962671905697446,86.94057682534726
450,41277,5389,588430,Fallout Shelter,46666,0.8845197788539836,86.94048307980961
451,43472,5716,287390,Metro: Last Light Redux,49188,0.8837927949906481,86.89435690410345
452,7386,866,1343370,Old School RuneScape,8252,0.8950557440620456,86.88955636940439
453,29321,3788,33230,Assassin's Creed 2,33109,0.885590020840255,86.87833190919568
454,26759,3448,417860,Emily is Away,30207,0.8858542721885656,86.8565179000889
455,868116,125055,359550,Tom Clancy's Rainbow Six Siege,993171,0.8740851273345678,86.8227979405928
456,43921,5834,346900,AdVenture Capitalist,49755,0.8827454527183197,86.79877529262787
457,44310,5890,570940,DARK SOULS: REMASTERED,50200,0.8826693227091633,86.795405308906
458,80361,10942,393380,Squad,91303,0.8801572785122066,86.79475196845232
459,14139,1765,571740,Golf It!,15904,0.889021629778672,86.78776816122823
460,8278,992,204340,Serious Sam 2,9270,0.8929881337648328,86.78602832609886
461,12240,1513,233270,Far Cry 3 - Blood Dragon,13753,0.8899876390605687,86.78434606388872
462,47770,6393,383870,Firewatch,54163,0.88196739471595,86.76112650541329
463,8402,1012,15620,"Warhammer 40,000: Dawn of War II",9414,0.8925005311238581,86.75200307237564
464,818,69,9340,Company of Heroes: Opposing Fronts,887,0.9222096956031567,86.75121977511468
465,21024,2721,41070,Serious Sam 3: BFE,23745,0.8854074542008844,86.68406938473842
466,14841,1896,11020,TrackMania Nations Forever,16737,0.8867180498297186,86.60198308380991
467,40167,5428,1086940,Baldur's Gate 3,45595,0.8809518587564426,86.58721345389075
468,13265,1685,248570,Toribash,14950,0.8872909698996656,86.58454585352439
469,164698,23412,251570,7 Days to Die,188110,0.875540906916166,86.58380334163328
470,13779,1783,1343400,RuneScape ,15562,0.8854260377843465,86.43399884994878
471,34501,4701,466560,Northgard,39202,0.8800826488444468,86.43373410662305
472,101183,14425,281990,Stellaris,115608,0.875224897930939,86.40000802602266
473,21454,2885,63380,Sniper Elite V2,24339,0.881465959981922,86.32252504962067
474,18025,2408,434650,Lost Castle / 失落城堡,20433,0.882151421719767,86.28899344668353
475,10775,1396,234650,Shadowrun Returns,12171,0.8853011256264892,86.26033243387857
476,52306,7407,286690,Metro 2033 Redux,59713,0.8759566593539095,86.22353487610229
477,11063,1447,102500,Kingdoms of Amalur: Reckoning,12510,0.8843325339728217,86.18782428487712
478,92589,13435,232090,Killing Floor 2,106024,0.8732834075303705,86.18219446329468
479,7712,982,31280,Poker Night at the Inventory,8694,0.8870485392224523,86.18179654952401
480,5842,731,212800,Super Crate Box,6573,0.8887874638673361,86.12178302245873
481,150223,22244,261550,Mount & Blade II: Bannerlord,172467,0.8710246018078821,86.11845731687309
482,605904,92547,252490,Rust,698451,0.8674967893238037,86.10995419561034
483,185,9,652410,Brigand: Oaxaca,194,0.9536082474226805,86.08586927460028
484,27767,3875,274940,Depth,31642,0.8775361860817901,86.08544970021204
485,17440,2384,291650,Pillars of Eternity,19824,0.8797417271993543,86.0426569797012
486,31993,4519,310560,DiRT Rally,36512,0.8762324715162139,86.03095512932629
487,17939,2468,1284410,GWENT: The Witcher Card Game,20407,0.8790611064830696,85.99480555761976
488,4632,575,3910,Sid Meier's Civilization III Complete,5207,0.8895717303629729,85.99399335719099
489,2784,328,91600,Sanctum,3112,0.8946015424164524,85.95580740686277
490,27458,3891,17410,Mirror's Edge,31349,0.8758812083320042,85.92260699453863
491,16868,2331,324800,Shadow Warrior 2,19199,0.8785874264284598,85.91443924178816
492,9054,1203,214340,Deponia,10257,0.882714243930974,85.89773198604564
493,56026,8212,823130,Totally Accurate Battlegrounds,64238,0.872162894237056,85.88754508526085
494,188522,28683,1174180,Red Dead Redemption 2,217205,0.8679450288897586,85.8841192595805
495,15375,2121,622650,Bendy and the Ink Machine,17496,0.8787722908093278,85.87681967049386
496,24963,3545,967050,Pacify,28508,0.8756489406482391,85.85212440538596
497,12330,1683,788100,Neon Abyss,14013,0.8798972382787412,85.84472745841074
498,8687,1163,244160,Homeworld Remastered Collection,9850,0.8819289340101523,85.79502581181974
499,32146,4647,678960,CODE VEIN,36793,0.8736988014024407,85.7919568981526
500,31102,4509,209000,Batman: Arkham Origins,35611,0.8733818202240881,85.74602412777178
501,39175,5759,403640,Dishonored 2,44934,0.8718342457827035,85.70505907603932
502,10423,1434,270150,RUNNING WITH RIFLES,11857,0.8790587838407692,85.65523380411145
503,295490,46361,1172470,Apex Legends,341851,0.8643824356225374,85.65173008717112
504,102708,15721,1468810,鬼谷八荒 Tale of Immortal,118429,0.8672537976340254,85.63468775007057
505,3744,476,380840,Teeworlds,4220,0.8872037914691943,85.58290010467327
506,12479,1758,301640,Zombie Army Trilogy,14237,0.8765189295497647,85.53609552979397
507,34948,5215,815370,Green Hell,40163,0.8701541219530413,85.49314962032672
508,5363,714,439190,Stories: The Path of Destinies,6077,0.882507816356755,85.47353244847858
509,11658,1646,20510,S.T.A.L.K.E.R.: Clear Sky,13304,0.8762778111846061,85.46975633501972
510,25759,3800,115300,Call of Duty: Modern Warfare 3,29559,0.8714435535708245,85.46911668301874
511,60678,9299,356190,Middle-earth: Shadow of War,69977,0.8671134801434757,85.4339636832935
512,8775,1224,40100,Supreme Commander 2,9999,0.8775877587758776,85.39885238523853
513,13258,1914,1094520,Sands of Salzaar,15172,0.8738465594516214,85.3237153901946
514,9856,1397,48720,Mount & Blade: With Fire & Sword,11253,0.8758553274682307,85.31851036090305
515,3198,412,12810,Overlord II,3610,0.8858725761772853,85.31014529453562
516,29318,4419,1030840,Mafia: Definitive Edition,33737,0.8690162136526662,85.30226329926282
517,34777,5325,208090,Loadout,40102,0.8672136053064685,85.21049973331934
518,3704,490,530620,Resident Evil 7 Teaser: Beginning Hour,4194,0.8831664282308059,85.20609800756806
519,22216,3356,21690,Resident Evil 5,25572,0.868762709213202,85.13898021108534
520,8512,1217,340,Half-Life 2: Lost Coast,9729,0.8749100626991468,85.12843180265386
521,62620,9924,582160,Assassin's Creed Origins,72544,0.8632002646669608,85.06988976289301
522,269209,44405,444090,Paladins,313614,0.8584087445075794,85.04691507017608
523,497,48,689580,TurnSignal,545,0.9119266055045872,85.01473381449043
524,17029,2571,492720,Tropico 6,19600,0.8688265306122449,85.00022817016895
525,18207,2773,335240,Transformice,20980,0.8678265014299332,84.9433877160295
526,61501,9870,335300,DARK SOULS II: Scholar of the First Sin,71371,0.8617085370808872,84.91972702515494
527,11280,1681,24740,Burnout Paradise: The Ultimate Box,12961,0.8703032173443407,84.88979899464107
528,77787,12618,518790,theHunter: Call of the Wild,90405,0.8604280736684918,84.88174760900819
529,84880,13884,236850,Europa Universalis IV,98764,0.8594224616256936,84.81484137600755
530,5076,724,96000,The Tiny Bang Story,5800,0.8751724137931034,84.75473273168448
531,5475,787,205950,Jet Set Radio,6262,0.8743213030980518,84.73874088166362
532,4713,671,17570,"Pirates, Vikings, and Knights II",5384,0.87537147102526,84.71055953184138
533,24288,3833,962130,Grounded,28121,0.8636961701219729,84.7045091620384
534,24016,3801,228380,Wreckfest,27817,0.8633569400007189,84.66668740710382
535,30509,4894,1238860,Battlefield 4,35403,0.8617631274185803,84.63097612391546
536,4774,690,292910,Deponia: The Complete Journey,5464,0.873718887262079,84.5702102381077
537,31875,5167,223710,Cry of Fear,37042,0.860509691701312,84.53182374017963
538,39478,6520,648350,Jurassic World Evolution,45998,0.8582547067263794,84.41109500241414
539,1494,194,23490,Tropico 3,1688,0.8850710900473934,84.39629738981678
540,4405,644,1220010,Home Behind 2,5049,0.8724499900970489,84.38565650911093
541,10383,1616,270550,Yet Another Zombie Defense,11999,0.865322110175848,84.37088617793738
542,10585,1657,872790,Football Manager 2019,12242,0.8646462996242444,84.3202835324148
543,48068,8066,976310,Mortal Kombat 11,56134,0.8563081198560587,84.30597052347115
544,21689,3539,47890,The Sims 3,25228,0.8597193594418899,84.2703265975359
545,4252,628,24720,SPORE Galactic Adventures,4880,0.8713114754098361,84.25118671131405
546,40573,6823,418460,Rising Storm 2: Vietnam,47396,0.8560427040256562,84.21123924126093
547,13383,2165,1466860,Age of Empires IV,15548,0.860753794700283,84.10121771749188
548,29839,5025,242860,Verdun,34864,0.8558685176686553,84.05965840807846
549,4664,708,610080,Realm Grinder,5372,0.8682055100521221,84.04606126022696
550,5657,873,234710,Poker Night 2,6530,0.8663093415007657,84.02823076823483
551,31537,5344,202970,Call of Duty: Black Ops II,36881,0.8551015427998157,84.01183481686145
552,6140,955,200170,Worms Revolution,7095,0.8653981677237491,84.00762988274113
553,24427,4108,302510,Ryse: Son of Rome,28535,0.8560364464692483,83.98076059185026
554,12324,2009,704850,Thief Simulator,14333,0.8598339496267355,83.96544275983992
555,12290,2006,729040,Borderlands Game of the Year Enhanced,14296,0.8596810296586458,83.94943833677662
556,18256,3053,314160,Microsoft Flight Simulator X: Steam Edition,21309,0.8567272044675959,83.89729363818915
557,284144,51546,582010,Monster Hunter: World,335690,0.8464476153594089,83.89285480407419
558,29558,5050,24960,Battlefield: Bad Company 2,34608,0.854079981507166,83.88510542016773
559,354544,64772,1085660,Destiny 2,419316,0.8455293859523605,83.85159464843815
560,10268,1675,12100,Grand Theft Auto III,11943,0.8597504814535711,83.84368722349406
561,14341,2385,242700,Injustice: Gods Among Us Ultimate Edition,16726,0.8574076288413249,83.82743985453584
562,17825,3010,474960,Quantum Break,20835,0.855531557475402,83.77165712586802
563,12039,1994,282440,Quake Live,14033,0.8579063635715812,83.77067342625804
564,70471,12520,581320,Insurgency: Sandstorm,82991,0.8491402682218554,83.75998250692078
565,30173,5229,633230,NARUTO TO BORUTO: SHINOBI STRIKER,35402,0.8522964804248347,83.72473712311937
566,20670,3532,599140,Graveyard Keeper,24202,0.8540616477977027,83.71025494105906
567,7439,1206,96100,Defy Gravity Extended,8645,0.8604973973395026,83.69576031396086
568,213442,39183,291550,Brawlhalla,252625,0.8448965858485898,83.67423934840089
569,31085,5425,644930,They Are Billions,36510,0.8514105724459052,83.65379200276618
570,51999,9239,1238840,Battlefield 1 ,61238,0.8491296253959959,83.64837861378376
571,9647,1596,201870,Assassin's Creed Revelations,11243,0.8580450057813751,83.64432556463147
572,280,28,3990,Civilization IV: Warlords,308,0.9090909090909091,83.62680646506134
573,66296,11914,1293830,Forza Horizon 4,78210,0.8476665388057794,83.5967706985612
574,21596,3740,110800,L.A. Noire,25336,0.8523839595832018,83.57362793635492
575,33061,5859,204100,Max Payne 3,38920,0.8494604316546762,83.49521846001038
576,8145,1353,222480,Resident Evil Revelations,9498,0.8575489576753,83.48536978528512
577,4023,638,293260,Card Hunter,4661,0.8631195022527355,83.45633768719183
578,6740,1111,208200,Doom 3: BFG Edition,7851,0.8584893644121768,83.43919539337725
579,3445,546,22600,Worms Reloaded,3991,0.8631921824104235,83.32647043230246
580,32936,5919,617290,Remnant: From the Ashes,38855,0.8476643932569811,83.32234465670889
581,1344529,260373,570,Dota 2,1604902,0.8377639257724148,83.3186861175783
582,7025,1174,34270,SEGA Mega Drive and Genesis Classics,8199,0.8568118063178436,83.3138231189739
583,1035799,200122,271590,Grand Theft Auto V,1235921,0.8380786474216394,83.31224830777305
584,2773,435,1520,DEFCON,3208,0.8644014962593516,83.23345435869263
585,22211,3966,204300,Awesomenauts - the 2D moba,26177,0.8484929518279406,83.21901366662267
586,5027,829,2400,The Ship: Murder Party,5856,0.8584357923497268,83.21192932584401
587,12093,2111,233290,Murdered: Soul Suspect,14204,0.8513798929878907,83.1620775736932
588,5230,871,20,Team Fortress Classic,6101,0.8572365186035076,83.13296353857949
589,61031,11365,268500,XCOM 2,72396,0.8430161887397094,83.12022978637287
590,1006,142,429470,Space Pilgrim Episode I: Alpha Centauri,1148,0.8763066202090593,83.11944485871014
591,48502,9023,504370,Battlerite,57525,0.8431464580617123,83.04810954586273
592,5160,867,274900,Murder Miners,6027,0.8561473369835739,83.0224402263378
593,3315,539,15700,Oddworld: Abe's Oddysee,3854,0.8601453035806954,83.01552769422788
594,20206,3684,690790,DiRT Rally 2.0,23890,0.8457932189200502,82.91653492606547
595,8658,1518,1399780,Spellbreak,10176,0.8508254716981132,82.9014382468624
596,21100,3885,532210,Life is Strange 2,24985,0.8445067040224135,82.81626778779567
597,8332,1470,17480,Command & Conquer: Red Alert 3,9802,0.8500306059987758,82.80222685372298
598,73735,14198,397540,Borderlands 3,87933,0.8385361582113655,82.75393778089838
599,9241,1665,1335200,Action Taimanin,10906,0.8473317439941317,82.61835120902981
600,2972,497,205230,Hell Yeah! Wrath of the Dead Rabbit,3469,0.8567310464110695,82.60693950402465
601,930,137,331160,Disney•Pixar Cars,1067,0.8716026241799437,82.60631532063547
602,28712,5439,601510,Yu-Gi-Oh! Duel Links,34151,0.8407367280606717,82.60229328469485
603,9934,1803,206210,Gotham City Impostors Free to Play,11737,0.8463832325125671,82.57538150249977
604,17382,3241,268050,The Evil Within,20623,0.8428453668234496,82.56130913162691
605,10192,1855,108800,Crysis 2 - Maximum Edition,12047,0.8460197559558397,82.55730626325995
606,83021,16299,524220,NieR:Automata,99320,0.8358940797422473,82.53758393186577
607,26629,5062,657200,Hand Simulator,31691,0.8402701082326213,82.52420473293822
608,330674,66984,1097150,Fall Guys: Ultimate Knockout,397658,0.8315537471897962,82.47156822017608
609,50269,9806,1151640,Horizon Zero Dawn Complete Edition,60075,0.8367707032875572,82.45019068724635
610,13646,2541,289130,ENDLESS Legend,16187,0.8430221782912214,82.44770948787745
611,16483,3103,464920,Surviving Mars,19586,0.841570509547636,82.41336093326323
612,3848,671,232770,POSTAL,4519,0.851515822084532,82.36136141639487
613,13274,2488,355180,Codename CURE,15762,0.8421520111660957,82.35052295479706
614,18507,3532,99900,Spiral Knights,22039,0.8397386451290894,82.30004747470971
615,15481,2937,12200,Bully: Scholarship Edition,18418,0.8405364317515474,82.28275735226246
616,12464,2353,383080,Sakura Clicker,14817,0.8411959236012688,82.22519507995938
617,8348,1552,278080,DYNASTY WARRIORS 8: Xtreme Legends Complete Edition,9900,0.8432323232323232,82.17159569093151
618,15688,3009,223750,DCS World Steam Edition,18697,0.839065090656255,82.15123635438756
619,47078,9397,750920,Shadow of the Tomb Raider: Definitive Edition,56475,0.8336077910579902,82.12260246492785
620,26184,5138,380600,Fishing Planet,31322,0.8359619436817572,82.10717495382505
621,23282,4567,44350,GRID 2,27849,0.8360084742719667,82.0579945310452
622,156917,32360,289070,Sid Meier’s Civilization VI,189277,0.8290336385297739,82.05481887348357
623,18688,3649,1128810,RISK: Global Domination,22337,0.8366387608004656,82.01202330709548
624,13943,2697,774861,Project Winter,16640,0.8379206730769231,81.98025527797702
625,8316,1578,206500,AirMech Strike,9894,0.8405093996361431,81.9159831008491
626,45567,9238,686810,Hell Let Loose,54805,0.8314387373414834,81.90258200549374
627,12830,2492,235600,Tom Clancy’s Splinter Cell Blacklist,15322,0.8373580472523169,81.8815173232745
628,10090,1945,15100,Assassin's Creed: Director's Cut Edition,12035,0.8383880348982136,81.83863092649514
629,12459,2425,70000,Dino D-Day,14884,0.8370733673743618,81.83836869779793
630,65857,13566,552500,Warhammer: Vermintide 2,79423,0.8291930549085278,81.8167049314544
631,17368,3442,544810,KARDS - The WWII Card Game,20810,0.8345987506006728,81.78266056455992
632,2589,462,17330,Crysis Warhead,3051,0.8485742379547689,81.74333622668262
633,16360,3247,505460,Foxhole,19607,0.834395879022798,81.73307435797437
634,72701,15172,1046930,Dota Underlords,87873,0.8273417318175094,81.67063985800112
635,27781,5654,1404210,Red Dead Online,33435,0.830895767907881,81.65154993568557
636,90306,18982,594650,Hunt: Showdown,109288,0.8263121294195154,81.63839282190696
637,13947,2775,262410,World of Guns: Gun Disassembly,16722,0.8340509508432006,81.61667944084554
638,812,130,17740,Empires Mod,942,0.861995753715499,81.59397518293991
639,36989,7699,376210,The Isle,44688,0.8277166129609739,81.46654690002862
640,44150,9239,447040,Watch_Dogs 2,53389,0.8269493715933994,81.46077204137835
641,15827,3203,1483870,Draw & Guess,19030,0.8316868102995271,81.46070452489266
642,48901,10263,389730,TEKKEN 7,59164,0.8265330268406463,81.45823515257253
643,29987,6254,1049590,Eternal Return: Black Survival,36241,0.8274330178527083,81.35442776154747
644,33337,6992,1222680,Need for Speed Heat,40329,0.8266260011406185,81.3210141368876
645,10116,2033,606150,Moonlighter,12149,0.8326611243723764,81.30536312278554
646,445613,98726,381210,Dead by Daylight,544339,0.8186314043270829,81.26525278438217
647,2270,419,6850,Hitman 2: Silent Assassin,2689,0.8441799925622908,81.22405518575442
648,33345,7045,240720,Getting Over It with Bennett Foddy,40390,0.8255756375340431,81.22090032790399
649,54674,11716,219640,Chivalry: Medieval Warfare,66390,0.8235276397047748,81.20906461930069
650,6774,1346,304650,SUNLESS SEA,8120,0.8342364532019705,81.19959770929125
651,15013,3095,392110,ENDLESS Space 2,18108,0.8290810691407113,81.1880257260372
652,17759,3686,447820,Day of Infamy,21445,0.8281184425273956,81.18192727689866
653,31769,6756,298110,Far Cry 4,38525,0.8246333549643089,81.1114383314284
654,15935,3314,374040,Portal Knights,19249,0.8278352122188165,81.10118252994909
655,28538,6083,236870,HITMAN,34621,0.8242973917564484,81.03509859771755
656,6098,1221,327030,Worms W.M.D,7319,0.8331739308648722,81.03001867298619
657,77483,17014,629760,MORDHAU,94497,0.819951956146756,80.97816665177476
658,70856,15583,379430,Kingdom Come: Deliverance,86439,0.8197225789284929,80.92832138637466
659,3232,629,253900,Knights and Merchants,3861,0.8370888370888371,80.90340944589776
660,52119,11420,218230,PlanetSide 2,63539,0.8202678669793355,80.87955249475812
661,13737,2891,250400,How to Survive,16628,0.826136636997835,80.8646537713926
662,89553,19969,306130,The Elder Scrolls Online,109522,0.8176713354394551,80.8012255491812
663,10657,2231,311340,METAL GEAR SOLID V: GROUND ZEROES,12888,0.826893234016139,80.79651499286015
664,35701,7801,307780,Mortal Kombat X,43502,0.820674911498322,80.78003760693636
665,12092,2557,578310,BRAIN / OUT,14649,0.8254488360980272,80.73170477620748
666,12338,2623,233720,Surgeon Simulator,14961,0.824677494819865,80.67030671821055
667,15854,3406,47870,Need For Speed: Hot Pursuit,19260,0.8231568016614745,80.65763463965926
668,20109,4360,637090,BATTLETECH,24469,0.8218153582083453,80.64516411105606
669,62732,14053,208650,Batman: Arkham Knight,76785,0.8169824835579866,80.62569518507682
670,6537,1370,242640,Styx: Master of Shadows,7907,0.8267358037182243,80.48197812432713
671,11369,2450,290340,Armello,13819,0.8227078659816195,80.44103374434626
672,6138,1289,39500,Gothic 3,7427,0.8264440554732732,80.41309399087937
673,31455,7058,637650,FINAL FANTASY XV WINDOWS EDITION,38513,0.816737205618882,80.35458227437937
674,16276,3578,460920,Steep,19854,0.8197844263120782,80.35263351362883
675,76952,17755,225540,Just Cause 3,94707,0.8125270571341083,80.25994183696965
676,383528,90949,346110,ARK: Survival Evolved,474477,0.8083173683866658,80.22877935700413
677,1771,349,33900,Arma 2,2120,0.835377358490566,80.19466780063938
678,17788,4008,238090,Sniper Elite 3,21796,0.8161130482657368,80.04867944007854
679,47162,10931,333930,Dirty Bomb,58093,0.811836193689429,80.0360469491396
680,742,136,16810,Sid Meier's Civilization IV: Colonization,878,0.8451025056947609,80.02569763892775
681,8284,1827,238370,Magicka 2,10111,0.8193057066561171,79.941589836098
682,67731,15970,304050,Trove,83701,0.8092018016511153,79.90076551956173
683,7375,1628,627690,Idle Champions of the Forgotten Realms,9003,0.8191713873153393,79.8583098402399
684,4997,1099,232010,Euro Truck Simulator,6096,0.8197178477690289,79.65261058752424
685,28777,6818,261640,Borderlands: The Pre-Sequel,35595,0.8084562438544739,79.53014125586523
686,74182,17988,386360,SMITE,92170,0.8048388846696322,79.5075990904268
687,20984,4939,383120,Empyrion - Galactic Survival,25923,0.8094742120896501,79.4954173581557
688,2303,494,285800,Braveland,2797,0.8233821952091527,79.37262648219908
689,208692,51924,377160,Fallout 4,260616,0.800764342941339,79.37198933531427
690,11444,2670,212500,The Lord of the Rings Online,14114,0.8108261300836049,79.33139948125061
691,23716,5685,280790,Creativerse,29401,0.8066392299581647,79.27872375499952
692,22671,5434,485510,Nioh: Complete Edition / 仁王 Complete Edition,28105,0.8066536203522505,79.26117118108988
693,28639,6912,884660,CRSED: F.O.A.D.,35551,0.8055750893083177,79.2538278412453
694,74579,18470,444200,World of Tanks Blitz,93049,0.8015024342013348,79.18739448765433
695,9499,2244,389570,Mitos.is: The Game,11743,0.8089074342161288,79.05127788889868
696,72466,18105,552990,World of Warships,90571,0.8001015777677182,79.04396361471682
697,919,188,490220,Prismata,1107,0.8301716350496838,79.01548707244027
698,55349,13792,214950,Total War: ROME II - Emperor Edition,69141,0.8005235677817792,79.00288432994611
699,42660,10592,646910,The Crew 2,53252,0.8010966724254488,78.97221120984914
700,3581,823,60,Ricochet,4404,0.8131244323342416,78.80760355864469
701,27266,6778,221040,Resident Evil 6,34044,0.8009047115497592,78.7898674371805
702,8019,1933,282660,Easy eSports,9952,0.8057676848874598,78.66300833247209
703,21691,5409,325610,Total War: ATTILA,27100,0.8004059040590406,78.64984730772076
704,3819,895,262280,Dungeons 2,4714,0.8101400084853627,78.58331062011608
705,1790,401,40,Deathmatch Classic,2191,0.8169785486079416,78.569351280762
706,6563,1585,258970,Gauntlet Slayer Edition,8148,0.805473735886107,78.51682137951421
707,7031,1711,208140,ENDLESS Space - Definitive Edition,8742,0.8042781972088767,78.44760266076779
708,89561,23377,552520,Far Cry 5,112938,0.7930103242487029,78.41830761248806
709,204578,54088,236390,War Thunder,258666,0.790896368289609,78.40676233504489
710,15218,3827,235540,Warhammer: End Times - Vermintide,19045,0.7990548700446312,78.36590946777886
711,22391,5705,495420,State of Decay 2: Juggernaut Edition,28096,0.7969461845102506,78.33474760398967
712,32944,8486,761890,Albion Online,41430,0.7951725802558532,78.31465425325578
713,12811,3218,378860,Project CARS 2,16029,0.7992388795308504,78.30130503381389
714,1936,446,308040,Back to Bed,2382,0.8127623845507976,78.26601399902403
715,13859,3511,24200,DC Universe Online,17370,0.7978698906160046,78.2104230533538
716,8679,2174,226840,Age of Wonders III,10853,0.7996867225651894,78.14127100908479
717,7562,1885,333420,Cossacks 3,9447,0.8004657563247591,78.13628944721793
718,8190,2051,394310,Punch Club,10241,0.7997265892002734,78.11280360058139
719,51452,13555,1203220,NARAKA: BLADEPOINT,65007,0.791483994031412,78.11142667375024
720,6748,1679,17080,Tribes: Ascend,8427,0.8007594636288121,78.09688862667925
721,9668,2441,17300,Crysis,12109,0.7984144025105293,78.08079882492818
722,1651,383,308600,Geneshift,2034,0.811701081612586,78.02409034157269
723,11725,3000,630100,SoulWorker - Anime Action MMO,14725,0.7962648556876061,77.97846894412736
724,3618,883,466910,Worm.is: The Game,4501,0.803821373028216,77.96760131355317
725,46,5,715210,The Pillage,51,0.9019607843137255,77.96076199296664
726,29423,7751,409710,BioShock Remastered,37174,0.7914940549846667,77.92239841497197
727,60793,16339,466240,Deceit,77132,0.7881683348026759,77.84309943728577
728,5230,1317,24780,SimCity 4 Deluxe Edition,6547,0.7988391629754086,77.76226340039848
729,29683,7906,838350,太吾绘卷 The Scroll Of Taiwu,37589,0.7896725105749023,77.75197964748061
730,6876,1754,32800,Lord of the Rings: War in the North,8630,0.7967555040556199,77.73678026744462
731,8791,2266,1408720,Krunker,11057,0.7950619517048024,77.71705129663698
732,49059,13242,438740,Friday the 13th: The Game,62301,0.7874512447633264,77.70932596899854
733,57555,15636,440900,Conan Exiles,73191,0.7863671762921671,77.65367177409335
734,15727,4166,368500,Assassin's Creed Syndicate,19893,0.7905796008646258,77.5815030168357
735,19808,5355,640820,Pathfinder: Kingmaker - Enhanced Plus Edition,25163,0.7871875372570838,77.35919208572851
736,8880,2350,350640,Sherlock Holmes: The Devil's Daughter,11230,0.7907390917186109,77.31919659956924
737,68380,19106,231430,Company of Heroes 2,87486,0.7816107720092358,77.24490728799441
738,14118,3831,893520,Creative Destruction,17949,0.7865619254554571,77.15437393158122
739,23792,6552,612880,Wolfenstein II: The New Colossus,30344,0.7840759293435275,77.13645768171344
740,17066,4661,895400,Deadside,21727,0.7854742946564183,77.13491152927442
741,46126,12912,460930,Tom Clancy's Ghost Recon Wildlands,59038,0.7812934042481113,77.09918299617034
742,8113,2171,1258080,Shop Titans,10284,0.7888953714507974,77.09915086152297
743,6764,1804,268420,Aura Kingdom,8568,0.7894491129785247,77.04976701721213
744,4044,1057,40390,Risen 2: Dark Waters,5101,0.7927857282885709,77.03774334280577
745,7963,2140,203290,America's Army: Proving Grounds,10103,0.7881817281995447,77.0226380090707
746,4696,1238,253980,Enclave,5934,0.7913717559824739,77.006415146925
747,12122,3310,9900,Star Trek Online,15432,0.7855106272680145,76.98513005413008
748,26396,7368,22370,Fallout 3: Game of the Year Edition,33764,0.7817794100225092,76.95697118510209
749,5207,1392,558100,Art of War: Red Tides,6599,0.7890589483255038,76.85855882853639
750,37489,10611,364360,Total War: WARHAMMER,48100,0.7793970893970894,76.85139786760897
751,12486,3457,302670,Call to Arms,15943,0.7831650254029981,76.77858953844158
752,15423,4298,287290,Resident Evil Revelations 2,19721,0.7820597332792455,76.76905520035592
753,12081,3348,299360,Block N Load,15429,0.7830060276103441,76.74831615958485
754,25915,7355,109600,Neverwinter,33270,0.7789299669371806,76.67899942169704
755,10168,2820,245620,Tropico 5,12988,0.7828765013858947,76.65351792306132
756,10495,2914,234630,Project CARS,13409,0.7826832724289656,76.650916798995
757,86835,25409,311210,Call of Duty: Black Ops III,112244,0.7736270981076939,76.53684805860607
758,59329,17277,359320,Elite Dangerous,76606,0.7744693627131034,76.5175792978911
759,25646,7381,285900,Gang Beasts,33027,0.7765161837284645,76.44546803584817
760,1371,354,38420,Fallout Tactics: Brotherhood of Steel,1725,0.7947826086956522,76.35178211067141
761,6137,1706,323580,Jotun: Valhalla Edition,7843,0.7824811934208848,76.34871727181027
762,7038,1971,342200,MechWarrior Online Solaris 7,9009,0.7812187812187812,76.30822789301591
763,40302,11879,952060,Resident Evil 3,52181,0.7723500891128955,76.1998374755291
764,12486,3599,9480,Saints Row 2,16085,0.7762511656823127,76.12875316970647
765,5611,1580,236690,Blood Bowl 2,7191,0.7802809066889167,76.09360252805124
766,3090,849,268850,EVGA Precision X1,3939,0.7844630616907845,76.09302582151045
767,35496,10560,386180,Crossout,46056,0.7707139134966128,76.0030286691944
768,4183,1178,567630,Blood of Steel,5361,0.7802648759559784,75.91334190674219
769,8763,2537,19900,Far Cry 2: Fortune's Edition,11300,0.7754867256637168,75.88912034901989
770,5798,1661,1238000,Mass Effect: Andromeda Deluxe Edition,7459,0.777315994101086,75.83853946845134
771,15946,4717,939960,Far Cry New Dawn,20663,0.7717175627933989,75.80683143012254
772,59209,17992,550650,Black Squad,77201,0.7669460240152329,75.79282228533464
773,4117,1170,65790,ARMA: Cold War Assault,5287,0.7787024777756761,75.7600730287542
774,5217,1519,212740,TERA - Action MMORPG,6736,0.7744952494061758,75.51732722411685
775,2647,753,263500,Dragons and Titans,3400,0.7785294117647059,75.44441410065792
776,14626,4416,236110,Dungeon Defenders II,19042,0.7680915870181704,75.42891915565853
777,11886,3584,9200,RAGE,15470,0.7683257918552037,75.36198881432105
778,11508,3469,297000,Heroes of Might & Magic III - HD Edition,14977,0.7683781798758096,75.352531069323
779,4844,1425,272060,Serena,6269,0.772691019301324,75.30764216524858
780,10110,3045,388410,Darksiders II Deathinitive Edition,13155,0.7685290763968073,75.30761235663348
781,22082,6859,269210,Hero Siege,28941,0.7630005874019558,75.10633782924717
782,23125,7221,393420,Hurtworld,30346,0.7620444210110064,75.0319130043628
783,24806,7777,313120,Stranded Deep,32583,0.7613172513273793,74.98721830645387
784,1328,376,513780,Turbo Pug DX,1704,0.7793427230046949,74.96061179251072
785,333712,109094,1091500,Cyberpunk 2077,442806,0.7536302579459176,74.85659379000128
786,9677,3000,224600,Defiance,12677,0.7633509505403486,74.80261954895214
787,24,3,575110,Magic Lantern,27,0.8888888888888888,74.62665484338989
788,71024,23184,12210,Grand Theft Auto IV: The Complete Edition,94208,0.75390625,74.58279053159325
789,40454,13191,1313860,EA SPORTS FIFA 21,53645,0.7541056948457452,74.45275413689339
790,8098,2556,1520470,封灵档案,10654,0.7600901070020649,74.41419892157673
791,19001,6132,8500,EVE Online,25133,0.7560179843233995,74.38935987150744
792,37323,12219,582660,Black Desert,49542,0.7533607847886642,74.3579207431771
793,6330,2015,215080,WAKFU,8345,0.7585380467345716,74.14755789841264
794,8620,2780,606280,Darksiders III,11400,0.756140350877193,74.07511353235847
795,3013,940,711810,Never Split the Party,3953,0.7622059195547686,74.05375337078353
796,12418,4063,209870,Blacklight: Retribution,16481,0.7534736969844062,73.9843992982063
797,9201,2991,453480,Shadowverse CCG,12192,0.7546751968503937,73.96802544380445
798,21872,7252,104900,ORION: Prelude,29124,0.7509957423430847,73.96250109670144
799,5597,1801,327690,Gigantic,7398,0.7565558258988916,73.89990509784359
800,16578,5492,905370,Conqueror's Blade,22070,0.7511554145899411,73.87867781448307
801,15062,4996,766570,Russian Fishing 4,20058,0.7509223252567554,73.82044324554852
802,5734,1856,261110,Killer is Dead - Nightmare Edition,7590,0.755467720685112,73.81197114520592
803,37264,12627,813820,Realm Royale,49891,0.7469082600068149,73.73959193828858
804,73620,25223,755790,Ring of Elysium,98843,0.7448175389253665,73.71401656425768
805,10258,3396,212070,Star Conflict,13654,0.7512816756994287,73.69824021088775
806,3651,1179,323910,SteamVR Performance Test,4830,0.7559006211180124,73.59908766280756
807,6421,2118,237310,Elsword,8539,0.7519615880079634,73.54477663119673
808,3648,1183,339280,Strife,4831,0.7551231629062306,73.52751434027547
809,10302,3466,208480,Assassin’s Creed III,13768,0.7482568274259151,73.41649963152607
810,7722,2585,39120,RIFT,10307,0.7491995731056563,73.37661799815334
811,5779,1921,378540,The Surge,7700,0.7505194805194805,73.35810081992251
812,2778,904,1207590,Builders of Egypt: Prologue,3682,0.7544812601846822,73.29969151348635
813,888,274,319830,AX:EL - Air XenoDawn,1162,0.7641996557659209,73.26422859571659
814,26190,9090,337000,Deus Ex: Mankind Divided,35280,0.7423469387755102,73.19837997360104
815,11417,3907,34870,Sniper: Ghost Warrior 2,15324,0.7450404594100757,73.157234773803
816,128219,45557,1063730,New World,173776,0.737840668446736,73.15471826156596
817,23249,8085,1259970,eFootball PES 2021 SEASON UPDATE,31334,0.7419735750303185,73.12502828324537
818,3605,1202,1930,Two Worlds Epic Edition,4807,0.7499479925109216,73.04734211347164
819,10577,3662,706990,BLOCKPOST,14239,0.7428190181894796,72.91747073528032
820,9945,3440,527430,"Warhammer 40,000: Inquisitor - Martyr",13385,0.7429958909226746,72.9085054266961
821,157149,56841,275850,No Man's Sky,213990,0.7343754381045843,72.85503411250487
822,2251,748,360,Half-Life Deathmatch: Source,2999,0.7505835278426142,72.80808230441106
823,7215,2499,364470,The Elder Scrolls: Legends,9714,0.7427424336009882,72.74384034956871
824,46537,16705,513710,SCUM,63242,0.7358559185351506,72.7395379804313
825,5410,1865,17430,Need for Speed Undercover,7275,0.7436426116838488,72.68851703998666
826,10022,3513,292120,FINAL FANTASY XIII,13535,0.7404506834133727,72.6731650597855
827,6348,2205,214420,Gear Up,8553,0.7421957207997194,72.63297893130137
828,14972,5342,239160,Thief,20314,0.7370286501919858,72.50607278435523
829,10440,3712,265550,Dead Rising 3 Apocalypse Edition,14152,0.7377049180327869,72.43233113969802
830,29477,10712,289650,Assassin's Creed Unity,40189,0.7334594043146134,72.38602328429741
831,7773,2753,12220,Grand Theft Auto: Episodes from Liberty City,10526,0.7384571537146114,72.37822245838396
832,2853,991,331360,Heavy Metal Machines,3844,0.7421956295525495,72.20117348866822
833,7396,2650,280,Half-Life: Source,10046,0.7362134182759307,72.14709037768085
834,2997,1050,667890,Dead Maze,4047,0.7405485544848036,72.08100084780618
835,25000,9234,470220,UNO,34234,0.73026815446632,72.03319093670582
836,85933,32317,301520,Robocraft,118250,0.7267061310782241,71.9970212144466
837,3664,1305,376570,WildStar,4969,0.7373717045683236,71.90605891194353
838,8262,3033,339610,Freestyle 2: Street Basketball,11295,0.7314741035856573,71.75280762880708
839,12996,4834,1056640,Phantasy Star Online 2,17830,0.7288839035333707,71.68644741825577
840,1982,703,696370,BROKE PROTOCOL: Online City RPG,2685,0.7381750465549348,71.60628191549343
841,22663,8552,243470,Watch_Dogs,31215,0.7260291526509691,71.60009733080464
842,5663,2084,207230,ArcheBlade,7747,0.7309926423131535,71.54030264267963
843,24064,9181,611500,Quake Champions,33245,0.723838171153557,71.40937744392403
844,9807,3696,783770,Ironsight,13503,0.7262830482115086,71.33631547269566
845,3016,1110,479130,ESEA,4126,0.7309743092583616,71.21313439515515
846,704,244,648120,Pixel Painter,948,0.7426160337552743,71.18073557186534
847,11438,4376,1240440,Halo Infinite,15814,0.7232831668142152,71.11266207195769
848,3259,1216,794600,LET IT DIE,4475,0.728268156424581,71.00955212905731
849,3069,1147,55110,Red Faction: Armageddon,4216,0.7279411764705882,70.94660267239382
850,44102,17386,1151340,Fallout 76,61488,0.7172456414259692,70.93864222149303
851,7135,2740,21100,F.E.A.R. 3,9875,0.7225316455696202,70.85710786781847
852,3146,1190,536930,MOBIUS FINAL FANTASY,4336,0.7255535055350554,70.74256485918394
853,10226,4004,238430,Contagion,14230,0.7186226282501756,70.6335605257861
854,4902,1896,47790,Medal of Honor,6798,0.7210944395410415,70.55742540948184
855,1689,641,265590,The Red Solstice,2330,0.7248927038626609,70.31033611376452
856,11208,4487,211500,RaceRoom Racing Experience,15695,0.7141127747690347,70.24289714333698
857,1859,716,6900,Hitman: Codename 47,2575,0.7219417475728155,70.10756139448264
858,13311,5400,744900,Dead Frontier 2,18711,0.7113997113997114,70.04584331664226
859,4085,1629,209670,Cortex Command,5714,0.7149107455372768,69.90149030781431
860,61148,25667,779340,Total War: THREE KINGDOMS,86815,0.7043483269020331,69.76847959660411
861,16975,7033,316010,Magic Duels,24008,0.7070559813395535,69.71142094785226
862,18369,7667,996470,eFootball  PES 2020,26036,0.7055231218313105,69.58929205228762
863,2906,1175,346330,BrainBread 2,4081,0.7120803724577309,69.47215846748485
864,2618,1056,9880,Champions Online,3674,0.7125748502994012,69.46166637258422
865,3387,1382,446150,GUNS UP!,4769,0.7102117844411826,69.37940703931497
866,61312,26401,1238810,Battlefield V,87713,0.6990069887017888,69.25377032613746
867,3369,1386,268870,Satellite Reign,4755,0.7085173501577287,69.22175567361842
868,4814,2002,32430,STAR WARS - The Force Unleashed Ultimate Sith Edition,6816,0.7062793427230047,69.18106542380879
869,4562,1918,202750,Alan Wake's American Nightmare,6480,0.7040123456790124,68.94832739421275
870,8084,3453,286940,S.K.I.L.L. - Special Force 2 (Shooter),11537,0.7007020889312646,68.86869511466907
871,9522,4092,550900,Metin2,13614,0.6994270603790216,68.80685658363733
872,4910,2083,212160,Vindictus,6993,0.7021307021307022,68.80619834521674
873,7720,3326,65930,The Bureau: XCOM Declassified,11046,0.6988955277928662,68.68316428184065
874,3549,1508,206480,Dungeons & Dragons Online,5057,0.7017994858611826,68.63144817217537
875,193764,87877,221100,DayZ,281641,0.687982218498017,68.36809715243012
876,5938,2596,216150,MapleStory,8534,0.6958050152331849,68.29694904040157
877,58329,26596,365590,Tom Clancy’s The Division,84925,0.6868295554901384,68.06967881486592
878,8778,3965,1407200,World of Tanks,12743,0.6888487797222004,67.78765723535976
879,8498,3864,232890,Stronghold Crusader 2,12362,0.6874292185730464,67.64395330769477
880,1642,720,13140,America's Army 3,2362,0.6951735817104149,67.63411126496817
881,6180,2802,239200,Amnesia: A Machine for Pigs,8982,0.6880427521710086,67.59044436437152
882,49570,23112,291480,Warface,72682,0.6820120525026829,67.57507737506776
883,634,272,510840,Evolvation,906,0.6997792494481236,67.40621568627483
884,41,14,1266680,Strobophagia | Rave Horror,55,0.7454545454545455,67.23887621015258
885,91553,43621,227940,Heroes & Generals,135174,0.6772974092650954,67.22374307235363
886,31190,14814,273350,Evolve Stage 2,46004,0.6779845230849492,67.09580391162085
887,4195,1947,427270,Orcs Must Die! Unchained,6142,0.6830022793878215,66.97576341817985
888,15015,7151,24010,Train Simulator 2022,22166,0.6773887936479293,66.86643439180615
889,72487,35291,304390,FOR HONOR,107778,0.6725584070960678,66.72862008681277
890,5104,2418,537180,Digimon Masters Online,7522,0.6785429407072587,66.63857648470348
891,5803,2793,57900,Duke Nukem Forever,8596,0.6750814332247557,66.36293721676418
892,4039,1934,343710,Kholat,5973,0.6762096099112673,66.3349031919625
893,10855,5288,409720,BioShock 2 Remastered,16143,0.6724276776311714,66.30979406404532
894,1672,795,232050,Eador. Masters of the Broken World,2467,0.6777462505066882,66.08183615766143
895,5528,2700,215280,Secret World Legends,8228,0.6718522119591638,66.0462356382958
896,6732,3379,442080,Riders of Icarus,10111,0.665809514390268,65.54811068924215
897,25795,13257,273110,Counter-Strike Nexon: Studio,39052,0.6605295503431322,65.38717727279064
898,6977,3572,242720,GunZ 2: The Second Duel,10549,0.6613897051853256,65.14641191595531
899,2593,1312,6880,Just Cause,3905,0.6640204865556978,65.04161002490638
900,7937,4151,244930,SNOW - The Ultimate Edition,12088,0.6566015883520847,64.73572846478541
901,3581,1885,835860,Dreadnought,5466,0.6551408708379071,64.35116226983715
902,1134,589,293540,Guns and Robots,1723,0.6581543818920488,64.13745953668517
903,3261,1737,240320,Panzar,4998,0.6524609843937575,64.07205559767505
904,12130,6620,224540,Ace of Spades: Battle Builder,18750,0.6469333333333334,63.933336462160796
905,542,279,279720,The I of the Dragon,821,0.6601705237515225,63.893227294743404
906,5523,2999,47410,Stronghold Kingdoms,8522,0.6480873034498944,63.83756855861489
907,12497,6854,372000,Tree of Savior (English Ver.),19351,0.6458064182729575,63.83360230990156
908,4154,2254,723780,Modern Combat Versus,6408,0.6482521847690387,63.76585976306299
909,9006,4948,368070,Sniper Ghost Warrior 3,13954,0.6454063351010463,63.71858902070681
910,663,348,347560,Terra Incognita ~ Chapter One: The Descendant,1011,0.655786350148368,63.638285680874226
911,2676,1469,1025580,Vainglory,4145,0.6455971049457178,63.373565425650234
912,22620,12865,113400,APB Reloaded,35485,0.6374524446949416,63.15850025633279
913,18964,10834,476600,Call of Duty: WWII,29798,0.636418551580643,63.028086766841554
914,711,388,254060,KnightShift,1099,0.6469517743403094,62.9102342062624
915,21644,12678,310950,Street Fighter V,34322,0.6306159314725249,62.49841091266508
916,21211,12429,844870,KurtzPel,33640,0.6305291319857312,62.48669460649634
917,31112,18305,680420,OUTRIDERS,49417,0.6295809134508368,62.4574337531085
918,1723,983,638070,Murderous Pursuits,2706,0.6367331855136733,62.40685700724088
919,3779,2211,298260,Only If,5990,0.6308848080133556,62.13404079158485
920,169,92,397720,Romance of the Three Kingdoms Maker / 三国志ツクール,261,0.6475095785440613,61.991403231663114
921,5855,3518,407530,ARK: Survival Of The Fittest,9373,0.624666595540382,61.67218215064499
922,5184,3112,286570,F1 2015,8296,0.6248794599807136,61.66232978418551
923,140,79,311860,Data Hacker: Initiation,219,0.639269406392694,61.18084135434086
924,13493,8403,209660,Call of Duty: Advanced Warfare - Gold Edition,21896,0.6162312751187432,61.0493585657108
925,5917,3685,394230,Battleborn,9602,0.616225786294522,60.88725494870931
926,10390,6506,391460,WARMODE,16896,0.614938446969697,60.88041073291402
927,4316,2682,22350,BRINK,6998,0.616747642183481,60.862351058059325
928,11322,7205,506540,Last Man Standing,18527,0.6111081124844822,60.534042975828875
929,33505,21591,397900,Business Tour - Board Game with Online Multiplayer,55096,0.608120371714825,60.407753870409366
930,6104,3948,809960,Radical Heights,10052,0.6072423398328691,60.05503506703347
931,16476,10781,209160,Call of Duty: Ghosts,27257,0.6044685768793338,59.96405581871452
932,5839,3842,767560,War Robots,9681,0.6031401714698895,59.66308937855336
933,12784,8517,517630,Just Cause 4 Reloaded,21301,0.6001596169193935,59.5174121902627
934,6738,4505,55100,Homefront,11243,0.5993062349906608,59.331484161696935
935,1603,1064,293180,Overcast - Walden and the Werewolf,2667,0.6010498687664042,59.16493666893091
936,4990,3366,298240,War Trigger 3,8356,0.5971756821445667,59.076502157760494
937,3095,2091,32500,STAR WARS: The Force Unleashed II,5186,0.5967990744311609,58.94273348833406
938,46893,32621,295110,Just Survive,79514,0.5897452021027744,58.67403086347598
939,6479,4521,482730,Football Manager 2017,11000,0.589,58.3594975092251
940,4961,3456,303390,Dead Bits,8417,0.5894023999049542,58.351743940084646
941,1778,1233,231060,Ragnarok Online 2,3011,0.590501494520093,58.238411118973296
942,5247,3688,436520,Line of Sight,8935,0.587241186345831,58.160079867861846
943,5535,3977,49540,Aliens: Colonial Marines Collection,9512,0.5818965517241379,57.670050895344325
944,15634,11400,302830,BLOCKADE 3D,27034,0.5783087963305468,57.4680792211697
945,11899,8678,65980,Sid Meier's Civilization: Beyond Earth,20577,0.578266997132721,57.43304547089482
946,973,710,417910,Street Warriors Online,1683,0.5781342840166369,56.97856409792009
947,10338,7747,437220,The Culling,18085,0.5716339507879458,56.78882670806467
948,982,723,6920,Deus Ex: Invisible War,1705,0.5759530791788856,56.786914529938436
949,2160,1610,235340,Prime World,3770,0.5729442970822282,56.682966051501346
950,4021,3061,113420,Fallen Earth Free2Play,7082,0.5677774639932223,56.30779338954688
951,5,3,1444740,Maniac Path,8,0.625,56.04859369180792
952,3581,2767,34830,Sniper: Ghost Warrior,6348,0.56411468178954,55.95202784069182
953,199,149,448470,Bacteria,348,0.5718390804597702,55.951104038501185
954,34777,27229,424370,Wolcen: Lords of Mayhem,62006,0.5608650775731381,55.86687365634858
955,2609,2021,332070,School of Dragons,4630,0.5634989200863931,55.84952545058472
956,3047,2415,1226470,Shadow Arena,5462,0.5578542658366898,55.35165960372055
957,115761,93225,433850,Z1 Battle Royale,208986,0.5539174872957997,55.25678590359282
958,4430,3551,544730,Catan Universe,7981,0.5550682871820574,55.138488710023395
959,22334,18037,360430,Mafia III: Definitive Edition,40371,0.5532188947511828,55.10336628657774
960,1020927,834407,578080,PUBG: BATTLEGROUNDS,1855334,0.5502658820460359,54.961381814368295
961,3142,2577,457330,High Octane Drift,5719,0.5493967476831614,54.57440860294104
962,13422,11306,355840,Survarium,24728,0.542785506308638,54.07493565105619
963,2680,2307,921060,Modern Combat 5,4987,0.5373972328052937,53.45155067960934
964,3125,2742,911400,Assassin's Creed III Remastered,5867,0.5326401908982444,53.02450882548554
965,19000,16777,253710,theHunter Classic,35777,0.5310674455655868,52.97445348832285
966,17231,15409,555570,Infestation: The New Z,32640,0.5279105392156863,52.668876759403474
967,1309,1167,439700,Z1 Battle Royale: Test Server,2476,0.528675282714055,52.59473467128834
968,260,233,247120,Portal 2 Sixense Perceptual Pack,493,0.5273833671399595,52.31508937389633
969,15,13,680780,DEATH TRAIN - Warning: Unsafe VR Experience,28,0.5357142857142857,52.27539483768725
970,3632,3337,304030,ArcheAge,6969,0.5211651599942603,51.969049554932866
971,1612,1516,814480,Mini World: Block Art,3128,0.5153452685421995,51.398459928822696
972,13731,13180,1254120,Bless Unleashed,26911,0.510237449370146,50.97625023693075
973,246,235,428950,"Kivi, Toilet and Shotgun",481,0.5114345114345115,50.96540196470236
974,30274,29149,1089350,NBA 2K20,59423,0.5094660316712384,50.912004272142255
975,5633,5471,530700,Argo,11104,0.5072946685878963,50.68529119028765
976,5512,5382,1180380,Stay Out,10894,0.5059665871121718,50.56031749238862
977,4757,4930,389430,Knight Online,9687,0.49107050686487047,49.163395087301865
978,5562,5875,349700,Romero's Aftermath,11437,0.4863163416979977,48.71376706084933
979,1004,1111,211160,Viking: Battle for Asgard,2115,0.47470449172576834,47.72277601008957
980,9113,10339,285190,"Warhammer 40,000: Dawn of War III",19452,0.4684865309479745,47.00985961373091
981,18318,20844,834910,ATLAS,39162,0.46774934885858743,46.90857752991788
982,11588,13230,583950,Artifact,24818,0.46691917156902246,46.849175785653564
983,4325,5021,1056960,Wolfenstein: Youngblood,9346,0.46276481917397816,46.513981045314054
984,955,1204,1408680,Nine to Five,2159,0.4423344140805929,44.80511234115335
985,4768,6329,1057240,Crucible Beta,11097,0.42966567540776784,43.39258492426651
986,1709,2301,337950,The SKIES - BETA,4010,0.4261845386533666,43.225833470938994
987,10696,14903,226700,Infestation: Survivor Stories 2020,25599,0.41782882143833744,42.16987866262138
988,1677,2400,335330,Brick-Force,4077,0.41133186166298746,41.85914948739802
989,322,478,215790,Dream Pinball 3D,800,0.4025,41.55293914475543
990,15403,22324,1225330,NBA 2K21,37727,0.40827524054390757,41.211915312787646
991,8938,13952,841370,NBA 2K19,22890,0.3904761904761905,39.58109970279961
992,324,542,522570,The Last Hope,866,0.3741339491916859,39.055786574295496
993,3811,6332,681660,Bless Online,10143,0.375727102435177,38.34608015979961
994,2879,5802,730310,DYNASTY WARRIORS 9,8681,0.3316438198364244,34.26234160237602
995,5489,13432,577800,NBA 2K18,18921,0.2901009460387929,30.092811993864892
996,120,745,1154790,XIII,865,0.13872832369942195,18.588605634174883
